# # # # # # # # # #
# _ _ _ _ _ _ _ T #
# _ / _ _ _ _ / _ #
# _ _ _ _ _ _ _ _ #
# O _ / V V / _ O #
# _ _ / / / / _ _ #
# _ _ _ _ _ _ _ _ #
# _ / _ J _ _ / _ #
# _ _ _ _ _ _ _ _ #
# # # # # # # # # #
4