# # # # # # # # # #
# _ _ O / _ / / T #
# _ / _ _ * _ / _ #
# V / P / / _ / _ #
# _ _ * _ _ O _ _ #
# _ / / / _ / _ / #
# _ / / / _ / _ _ #
# _ J / _ _ _ / _ #
# / _ _ _ / _ _ _ #
# # # # # # # # # #
1