# # # # # # # # # #
# J _ _ / O _ _ _ #
# _ / _ / / / P _ #
# _ / _ / / / P _ #
# _ _ _ / V / _ _ #
# _ / / / _ / _ P #
# _ / / / _ / _ _ #
# _ _ _ / _ / _ _ #
# _ _ O / _ _ _ T #
# # # # # # # # # #
2