# # # # # # # # # #
# T _ / / _ _ _ _ #
# _ _ / _ _ / _ _ #
# P _ _ _ / P _ P #
# P P _ _ / P _ O #
# / / / / / / / / #
# P _ _ _ _ _ P _ #
# P _ P _ P _ _ _ #
# O _ P _ V P P J #
# # # # # # # # # #
3